...X.....................
.X.X....XXXXXXXXXXXXXXXXX
.X.X.....................
.X.XXXXXXXXXXXXXXXXXXXX.X
.........................
.X.......................
.........................
.........................
.........................
.........................